WWWWWWWWWWWWWWW       WWWWWWWWWWWWWWWwWWWWWWWWWWWWWWWWWWWWWW     WWWWWWWWWWWWWW
W                             O                                               W
W   wwwwwwwwwww       ww                         wwwwwwwwwww     wwwwwwwwwww  W
W   wwwwwwwwwww       ww                         wwwwwwwwwww     wwwwwwwwwww  W
    WWWWWWWWWWW       WW                         WWWWWWWWWWW     WWWWWWWWWWW   
W   WWWWWWWWWWW       WW                         WWWWWWWWWWW     WWWWWWWWWWW  W
    WWWWWWWWWWW       WW                         WWWWWWWWWWW     WWWWWWWWWWW   
    WWWWWWWWWWW       WW                         WWWWWWWWWWW     WWWWWWWWWWW   
    WWWWWWWWWWW       WW                         WWWWWWWWWWW     WWWWWWWWWWW   
                          WWWWWWWWW    WWWWwwww                                
                          WWWWWWWWW    WWWWwwww                                
           h                                                p                  
                          WWWWWWWWW    WWWWwwww                                
                          WWWWWWWWW    WWWWwwww                                
    WWWWWWWWWWWW      WWWWWWWWWWWWW    WWWWWWWWWWWWWWWWWWWWWWW     WWWWWWWWW   
    WWWWWWWWWWWW      WWWWWWWWWWWWW    WWWWWWWWWWWWWWWWWWWWWWW     WWWWWWWWW   
    WWWWWWWWWWWW      WWWWWWWWWWWWW    WWWWWWWWWWWWWWWWWWWWWWW     WWWWWWWWW   
    WWWWWWWWWWWW      WWWWWWWWWWWWW    WWWWWWWWWWWWWWWWWWWWWWW     WWWWWWWWW   
    WWWWWWWWWWWW      WWWWWWWWWWWWW    WWWWWWWWWWWWWWWWWWWWWWW     WWWWWWWWW   
    WWWWWWWWWWWW      WWWWWWWWWWWWW    WWWWWWWWWWWWWWWWWWWWWWW     WWWWWWWWW   
    WWWWWWWWWWWW      WWWWWWWWWWWWW    WWWWWWWWWWWWWWWWWWWWWWW     WWWWWWWWW   
    WWWWWWWWWWWW      WWWWWWWWWWWWW    WWWWWWWWWWWWWWWWWWWWWWW     WWWWWWWWW   
                                       p                                       
WWWWWWWWWWWWWWWW      WWWWWWWWWWWWwwwwwwWWWWWWWWWWWWWWWWWWWWWW     WWWWWWWWWWWW